1111111111111111111
100000000CCC0001111
100101111100P001111
1001000000000001111
1001000000000001111
1000111110110001E01
1111111111111111111
