1111111
1000001
1PC0E01
1000S01
1111111