1111111111111111111111111111111111
1P100001C0000000010CS0100001000C01
1C00010111111001010000111011000011
10111101S0001001C1C00C001110001001
100001010000110001110110001C011001
1C111100010000C0010C0100001111C001
101000010111111111000100100C100011
10111C0100000000010001011000101001
1010CC01111111110110110100111010C1
1C10100000000001001010010010001111
1011111100010S0100101011E010000001
1000C00111110101000010C11111110101
1C0010010C01C101011111111C0000C001
11111001100101011100C0S00001001001
1S0C0000C0000100000110001001001CC1
1111111111111111111111111111111111