1111111111111111111
1000000CCCP00001111
1001011111000001111
1001000000000001111
1001000000S00001111
1000111110110000E01
1111111111111111111