1111111111111111111
100000000CCP0001111
1001011111000001111
1001000000000001111
1001000000E00001111
1000111110110000C01
1111111111111111111