1111111111111111111
1000000000P00001111
100101111100E001111
1001000000000001111
1001000000000001111
1000111110110001C01
1111111111111111111